#British Isles
region_england = {
	17 21 22 23 24 25 26 27 28 29 30 31 32 52 53 55 56 57 58 59 61 62 63 66 67 68 69 70 71 72 73 1475 1476 1477 1478 1479 1480 1481 1482
}

region_ireland = {
	3 4 5 7 8 9 10 11 12 13 14 15 16 1462 1463 1464 1465 1466
}

region_scotland = {
	35 37 38 39 40 41 42 43 44 45 46 47 48 49 50 51 54 1483 1484 1485
}

region_wales = {
	18 19 20 60 64 65 908 1472 1473 1474
}

#Central Europe
region_bohemia = {
	362 363 436 437 438 439 440 441 446
}

region_carpathia = {
	442 443 444 445 450 451 452 453 454 517 518 519 520 521 522 523 524 525 533 537 538 539 540
}

region_frisia = {
	79 80 81 82 83 84 85 92 117 1487 1488
}

region_germany = {
	86 87 88 119 120 121 122 123 125 245 246 247 248 249 250 251 252 253 254 255 256 257 258 259 261 310 311 313 314 315 316 358 359 360 361 447 448 449 455 456 457 458 848
}

region_lotharingia = {
	89 90 91 115 116 118 124 126 127 128 129 133 134 930 1515 1516 1517 1518
}

region_poland = {
	428 429 430 431 432 433 434 435 526 527 528 529 530 531 532
}

region_pomerania = {
	260 262 304 306 307 308 309 312 364 365 366 367 368 369
}

#Western Europe
region_aquitaine = {
	141 142 143 144 145 146 147 148 149 150 151 208 209 210 211 212 213 214 215 216 217 218 219 220 223 616 1499 1500 1501
}

region_brittany = {
	101 102 103 104 105 106 1496 1497
}

region_burgundy = {
	135 221 222 224 227 228 229 237 238 239 240 241 242 244 1498
}

region_france = {
	74 75 76 77 78 93 94 95 96 97 98 99 100 107 108 109 110 111 112 113 114 130 131 132 136 137 138 139 140 225 226 1506 1507 1508 1509 1510 1511 1512 1513 1514
}

#Southern Europe
region_bulgaria = {
	498 499 500 501 506 507 508 509 510
}

region_byzantium = {
	470 471 472 473 474 475 476 477 478 479 480 481 482 484 485 487 488 489 490 491 492 493 494 495 496 497 744 756 757 1495
}

region_croatia = {
	459 460 461 462 463 464 465 466 467 504
}

region_italy = {
	230 231 232 233 234 235 236 243 317 318 319 320 321 322 323 324 325 326 327 328 329 330 331 332 333 349 350 351 352 353 354 355 356 357 929 1519 1520 1521 1522 1523 1524 1525 1526 1527 1528 1529
}

region_serbia = {
	468 469 502 503 505 1504 1505
}

region_sicily = {
	334 335 336 337 338 339 340 341 342 343 344 345 346 347 348 812 851 935 1502 1503
}

region_wallachia = {
	511 512 513 514 515 516 541 542 545
}

#Eastern Europe
region_alania = {
	596 597 598 599 603 604 605 606 607
}

region_crimea = {
	543 556 557 558 559 560 561 562 563 564 565
}

region_cuman = {
	566 594 595 608 615 617 618 619 620 891 892 893 895 896 897 898 1132 1273 1306 1329 1427 1430 1433 1434 1435 1486
}

region_lithuania = {
	370 371 372 373 374 416 419 420 421 422 423 424 425 426 427 934
}

region_livonia = {
	375 376 377 378 379 380
}

region_muscovy = {
	417 418 550 551 567 568 569 570 573 575 576 577 578 580 581 582 583 584 585 587 933
}

region_novgorod = {
	404 405 406 407 408 409 410 411 412 413 414 415 571 572 574 586
}

region_perm = {
	394 395 396 397 398 399 400 402 403 612 886 887 888 889 890 924 1205 1223
}

region_rus = {
	534 535 536 544 546 547 548 549 552 553 554 555
}

region_volga = {
	401 579 588 589 590 591 592 593 609 610 611 613 614
}

#Scandinavia
region_denmark = {
	6 221 263 264 265 266 267 302 303 305 1489
}

region_finland = {
	291 381 382 383 384 385 386 387 388 390 392 393 850
}

region_north_sea = {
	1 2 33 34 36 1439 1440
}

region_norway = {
	268 269 270 271 272 273 274 275 276 277 278 389 391
}

region_sweden = {
	279 280 281 282 283 284 285 286 287 288 289 290 292 293 294 295 296 297 298 300 301 931 932
}

# Iberia
region_andalusia = {
	164 165 166 167 168 169 178 179 180 181 182 183 196 1494
}

region_aragon = {
	170 171 172 173 174 175 202 203 204 205 206 207 826 827 1438 1491
}

region_asturias = {
	155 156 157 184 189 190 191 192 193 194 195
}

region_castille = {
	154 176 177 197 198 199 200 1492 1493
}

region_navarra = {
	152 153 201
}

region_portugal = {
	158 159 160 161 162 163 185 186 187 188 1490 
}

#Central Asia
region_afghanistan = {
	299 907 1182 1183 1185 1187 1189 1275 
}

region_arabia = {
	649 650 651 652 653 654 655 716 717 718 719 720 721 722 783 784 855 856 857 858 859 860 861 862 863 864 865 866 867 868 869 870 1282 1344 1380 1530 1531
}

region_baluchistan = {
	637 852 853 854 894 899 1113 1139 1184 1370
}

region_jerusalem = {
	723 725 769 770 771 772 773 774 775 776 777 778 779 780 781 782
}

region_khwarizm = {
	621 622 623 624 625 626 627 628 629 631 900 901 902 903 1181 1186 1188 1378 1423 1424 1425 1426 1431 1432
}

region_mesopotamia = {
	715 691 694 692 689 656 690 693 687 695 696 697 685 711 700 698 683 684 
}

region_persia = {
	630 632 633 634 635 636 638 639 640 641 642 643 644 645 646 647 648 657 658 659 660 661 663 664 665 688 904 905 906 1377
}

region_syria = {
	709 710 712 713 714 724 726 727 728 729 730 731 732 733 763 764 765 766 767 768
}

#Asia Minor
region_armenia = {
	672 681 682 699 701 702 703 706 707 708 734 735 736 758 761 762 1013
}

region_azerbaijan = {
	666 667 668 669 670 671 673 674 675 686
}

region_georgia = {
	600 601 602 676 677 679 680
}

region_nikaea = {
	483 486 737 740 741 742 743 745 746 747 748 749 750 751 752 753 754 755 759 760
}

region_trebizond = {
	678 704 705 738 739
}

# West Africa
region_algiers = {
	820 821 822 823 824 825 828 829 830 831 832 833 834 835 836
}

region_mauretania = {
	846 847 849 920 921 1459 1460 1461
}

region_morocco = {
	837 838 839 840 841 842 843 844 845 916 918
}

region_west_africa = {
	#Ghana
	912 913 915 917 919 1444 1445 1446 1447 1448 1449
	#Jolof
	1450 1451 1452 1453 1454 1455 1456 1457 1458
	#Mali
	914 911 922 925 927 1443 928
}

# East Africa
region_abyssinia = {
	871 872 873 874 875 876 877 880 881 882 883 884 885 1280 1326 1335 1343 1369 1373 1379 1417 1428 1429 1436 1437
}

region_africa = {
	805 806 807 808 809 810 811 813 814 815 816 817 818 819
}

region_egypt = {
	785 786 787 788 789 790 791 795 796 797 798 799 800 801 802 803 804 1467 1468 1469 1470
}

region_nubia = {
	792 793 794 878 879 1320 1322 1330 1332 1334 1471
}

#India

region_bengal = {
	#Bengal
	1319 1240 1236 1318 1131 1325 1381 1324 1243 1242 1151 1153 1323 1233 1239 1235 1232 1238
	#Bihar
	1419 1162 1420 1163 1166 1281 1241 1327 1237 1248 1234 1154 1251 1276 1152
	#Gondwana
	1271 1164 1272 1277 1165
	#Kamarupa
	1321 1244 1246 1296 1245 1418 1177
	#Orissa
	1155 1160 1230 1249 1270 1129 1231 1229 1156 1247 1225 1228 1224 1128 1227 1252 1226
}

region_deccan = {
	#Andhra
	1123 1221 1415 1222 1122 1207 1199 1204
	#Karnata
	1143 1158 1210 1265 1196 1216 1118 1217 1121 1197 1218 1203 1202 1140 1198
	#Lanka
	1215 1279 1195 1194 1414
	#Maharastra
	1285 1159 1286 1269 1254 1220 1125 1124 1260 1264 1213 1145 1142 1259 1258 1261 1212 1146 1416 1206
	#Tamilakam
	1115 1120 1112 1214 1201 1116 1114 1413 1117 1200 1360 1119 1219
	#Telingana
	1256 1208 1255 1157 1209 1253 1211 1257 1144
}

region_rajastan = {
	#Delhi
	1368 1367 1366 1364 1352 1359 1141 1357 1358 1173 1168
	#Gujarat
	1292 1290 1291 1268 1136 1295 1134 1266 1267 1135 1127 1126 1133
	#Kosala
	1356 1167 1169 1284 1283 1328 1422 1421 1250 1301 1171 1274 1278
	#Malwa
	1289 1149 1148 1288 1150 1170 1298 1299 1147 1287 1263 1262
	#Punjab
	1338 1375 1337 1178 1340 1376 1362 1363 1192 1361 1179 1193 1190 1180 1342 1341 1161 1191
	#Rajputana
	1130 1176 1174 1349 1350 1354 1304 1336 1294 1345 1302 1300 1346 1355 1353 1172
	#Sindh
	1297 1331 1137 1303 1333 1138 1175 1339 1374 1372 1371
}

